3,3,3,3,3,3,4,4,4,4,4,4,4,4,4,4,4,4,4,4,4,4,4,4,1,1,1,1,1,1,1,1,1,1,1,1,1,1,1,1,1,1,0,0,0,0,0,0,
3,5,5,5,5,3,4,4,4,4,4,4,4,4,4,4,4,4,4,4,4,4,4,4,1,1,1,1,1,1,1,1,1,1,1,1,1,1,1,1,1,1,0,2,2,2,2,0,
3,5,5,5,5,3,4,3,3,3,4,4,4,3,4,4,4,4,4,4,4,4,4,4,1,1,1,1,1,1,1,1,1,1,0,1,1,1,0,0,0,1,0,2,2,2,2,0,
3,5,5,5,5,3,4,4,4,4,3,4,4,4,3,4,4,4,4,4,4,4,4,4,1,1,1,1,1,1,1,1,1,0,1,1,1,0,1,1,1,1,0,2,2,2,2,0,
3,5,5,5,5,3,4,4,4,3,4,4,4,4,4,3,4,4,4,4,4,3,4,4,1,1,0,1,1,1,1,1,0,1,1,1,1,1,0,1,1,1,0,2,2,2,2,0,
4,4,4,4,4,4,4,4,3,4,4,4,4,4,4,4,3,4,3,4,3,4,4,4,1,1,1,0,1,0,1,0,1,1,1,1,1,1,1,0,1,1,1,1,1,1,1,1,
4,4,4,4,4,4,4,4,4,4,4,4,4,4,4,4,4,4,4,3,4,4,4,4,1,1,1,1,0,1,1,1,1,1,1,1,1,1,1,1,1,1,1,1,1,1,1,1,
4,4,4,4,4,4,4,4,4,4,4,3,4,4,3,4,4,4,4,4,4,4,4,4,1,1,1,1,1,1,1,1,1,0,1,1,0,1,1,1,1,1,1,1,1,1,1,1,
4,4,4,4,4,4,4,4,4,4,4,3,4,4,4,3,4,4,4,4,4,4,4,4,1,1,1,1,1,1,1,1,0,1,1,1,0,1,1,1,1,1,1,1,1,1,1,1,
3,3,3,3,3,3,3,3,4,4,4,3,4,4,4,4,3,4,4,3,4,4,4,4,1,1,1,1,0,1,1,0,1,1,1,1,0,1,1,1,0,0,0,0,0,0,0,0,
4,4,4,4,4,4,4,4,4,4,4,3,4,4,4,4,3,4,4,3,3,3,4,4,1,1,0,0,0,1,1,0,1,1,1,1,0,1,1,1,1,1,1,1,1,1,1,1,
4,4,4,4,4,4,4,3,3,3,3,3,4,4,4,3,4,4,4,4,4,4,4,4,1,1,1,1,1,1,1,1,0,1,1,1,0,0,0,0,0,1,1,1,1,1,1,1,
4,3,4,4,3,4,4,4,4,4,4,4,4,4,4,4,4,4,4,4,4,3,4,4,1,1,0,1,1,1,1,1,1,1,1,1,1,1,1,1,1,1,1,0,1,1,0,1,
4,3,4,4,3,4,4,3,3,3,3,3,3,3,3,3,3,3,4,4,4,4,3,4,1,0,1,1,1,1,0,0,0,0,0,0,0,0,0,0,0,1,1,0,1,1,0,1,
4,3,3,3,3,4,4,4,4,4,4,4,4,4,4,4,4,4,4,4,4,3,4,4,1,1,0,1,1,1,1,1,1,1,1,1,1,1,1,1,1,1,1,0,0,0,0,1,
4,4,4,4,4,4,4,3,3,3,3,3,4,4,4,3,4,4,4,4,4,4,4,4,1,1,1,1,1,1,1,1,0,1,1,1,0,0,0,0,0,1,1,1,1,1,1,1,
4,4,4,4,4,4,4,4,4,4,4,3,4,4,4,4,3,4,4,3,3,3,4,4,1,1,0,0,0,1,1,0,1,1,1,1,0,1,1,1,1,1,1,1,1,1,1,1,
3,3,3,3,3,3,3,3,4,4,4,3,4,4,4,4,3,4,4,3,4,4,4,4,1,1,1,1,0,1,1,0,1,1,1,1,0,1,1,1,0,0,0,0,0,0,0,0,
4,4,4,4,4,4,4,4,4,4,4,3,4,4,4,3,4,4,4,4,4,4,4,4,1,1,1,1,1,1,1,1,0,1,1,1,0,1,1,1,1,1,1,1,1,1,1,1,
4,4,4,4,4,4,4,4,4,4,4,3,4,4,3,4,4,4,4,4,4,4,4,4,1,1,1,1,1,1,1,1,1,0,1,1,0,1,1,1,1,1,1,1,1,1,1,1,
4,4,4,4,4,4,4,4,4,4,4,4,4,4,4,4,4,4,4,3,4,4,4,4,1,1,1,1,0,1,1,1,1,1,1,1,1,1,1,1,1,1,1,1,1,1,1,1,
4,4,4,4,4,4,4,4,3,4,4,4,4,4,4,4,3,4,3,4,3,4,4,4,1,1,1,0,1,0,1,0,1,1,1,1,1,1,1,0,1,1,1,1,1,1,1,1,
3,5,5,5,5,3,4,4,4,3,4,4,4,4,4,3,4,4,4,4,4,3,4,4,1,1,0,1,1,1,1,1,0,1,1,1,1,1,0,1,1,1,0,2,2,2,2,0,
3,5,5,5,5,3,4,4,4,4,3,4,4,4,3,4,4,4,4,4,4,4,4,4,1,1,1,1,1,1,1,1,1,0,1,1,1,0,1,1,1,1,0,2,2,2,2,0,
3,5,5,5,5,3,4,3,3,3,4,4,4,3,4,4,4,4,4,4,4,4,4,4,1,1,1,1,1,1,1,1,1,1,0,1,1,1,0,0,0,1,0,2,2,2,2,0,
3,5,5,5,5,3,4,4,4,4,4,4,4,4,4,4,4,4,4,4,4,4,4,4,1,1,1,1,1,1,1,1,1,1,1,1,1,1,1,1,1,1,0,2,2,2,2,0,
3,3,3,3,3,3,4,4,4,4,4,4,4,4,4,4,4,4,4,4,4,4,4,4,1,1,1,1,1,1,1,1,1,1,1,1,1,1,1,1,1,1,0,0,0,0,0,0